111111111111111
10000000C000001
100000000000001
1P0000001111111
100000000000001
100000001000001
10000000100E001
111111111111111
